d00010101110111
101m00100000001
100011001101011
110000011101011
100111011010001
100011001011101
101011100000011
101010000111011
100110110100011
101100000101011
100011110100001
111010000111001
100010111111001
101110100000001
1111111111111gs